NO ./textures/north.xpm
SO ./textures/south.xpm
EA ./textures/east.xpm
WE ./textures/west.xpm

C 0,0,255
F 0,255,0

11111111111111
10000000000001
10000000000001
10000000010001
1000W000010001
10000000010001
10000000010001
10000000000001
10000000000001
11111111111111
